12
3,5,5,5,7,7,7,5,5,5,5,6
11,5,5,7,12,11,14,1,7,7,4,10
11,5,5,14,3,13,13,6,10,10,3,14
11,5,5,14,11,5,5,14,10,11,15,14
9,5,5,12,9,5,5,12,10,10,9,14
2,2,2,2,2,3,6,1,13,13,4,10
9,15,13,13,13,13,12,1,7,7,4,10
3,13,5,6,3,5,5,6,10,10,3,14
11,5,5,14,11,5,5,14,10,11,15,14
11,5,5,14,9,7,7,12,10,10,9,14
11,5,5,13,4,11,14,1,13,13,4,10
9,5,5,5,5,13,13,5,5,5,5,12
